NO ./bonus/assets/textures/north.xpm
SO ./bonus/assets/textures/south.xpm
WE ./bonus/assets/textures/west.xpm
EA ./bonus/assets/textures/east.xpm

F 64,64,64,0
C 128,128,128,0

1 11111111111111111
1010000000000000001
1001000111100001001
1001000011000001001
1001000011000001001
1001000111100001001
1000000000000000101
1111111111111111 1