NO ./mandatory/assets/textures/north.xpm
SO ./mandatory/assets/textures/south.xpm
WE ./mandatory/assets/textures/west.xpm
EA ./mandatory/assets/textures/east.xpm

F 64,64,64
C 128,128,128

11111
100101
101001
1100N1
111111